          WWWW        
   WWWW   WWWW        
   WWWW   WWWW    T   
   WWWW   WWWW        
   WWWW   WWWW        
   WWWW   WWWW   WWWWW
   WWWW   WWWW   WWWWW
   WWWW   WWWW   WWWWW
   WWWW   WWWW   WWWWW
   WWWW   WWWW   WWWWW
   WWWW          WWWWW
   WWWW          WWWWW
   WWWW          WWWWW
s  WWWW          WWWWW
